111111111111111111
100000000000000001
1P000C000100000001
110000C001CCCC1111
1C10000001111CCCC1
1000001001CCCC1111
1000000C01111CCCC1
1C0C0C0C01CCCC1111
10C0C0C0C1111CCCC1
1101010101CCCC1111
1CCCCCCCC1111CCCE1
111111111111111111
