11111111111111111111111111111111111111111111111111111111111111111111111111111
1P00000000000000C100000000C00010000000000000000001000000000000000000000000001
11C0000000011111CC000000C0000000100000011000000C01CCCCCCCCC1C1C1C1C1C10000111
10000000CCCC00000000CCCC00001000000000011CC0000001111111111000000000000000001
10000000000CCCCC00000000000011111111111000000CCCCC0000000000CCCCCCC0000000001
10000000000000000000000000000000000000011000000000000000000000000000000000001
1CCCCCCCCCCCCCCCCCCCCCCCCCCCCCCCCCCCCCC110000000000000001111110C10C10C010C101
11111111111111111111111111111111111111111000000000000000000000000000000000001
1CCCCCCCCCCCCCCCCCCCCCCCCCCCCCCCCCCCCCCC1000000000000000000000000000000000001
1CCCCCCCCCCCCCCCCCCCCCCCCCCCCCCCCCCCCCCC1000000000000000000000000000000000001
10111111111111111111111111111111111111111000000000000000000000000000000000001
10000000000000000000000000000000000000000000000000000000000000000000000000001
11111111111111111111111101111111111111111000000000000000000000000000000000001
1CCCCCCCCCCCCCCCCCCCCCCCCCCCCCCCCCCCCCCC1000000000000000000000000000000000001
11111111111111111111111111111111111111111000000000000000000000000000000000001
10000000000000000000000000000000000000000000000000000000000000000000000000001
1000000000CCCCCCCCCCCCCCCCC00000000000001000000000000000000000000000000000001
10000000001111111111111111111111111111111000000000000000000000000000000000001
1000000000CCCCCCCCCCCCCCCCCCCCCCCCCCCCCE1000000000000000000000000000000000001
11111111111111111111111111111111111111111111111111111111111111111111111111111
