1111111111111111111111111111111111111
1E1CCCCCCCCC1CCCCCCC1P1CCCCCCCCCCCCC1
1CCCCCCCCCCC1CCCCCCCCCC1CCCCC11111111
1CCCCCCCCCCCCCCCCCCCCCCCCCCCCCCCCCCC1
1111111111111111111111111111111111111
