1111111111
1P000000C1
1000011111
10000000C1
11111111C1
1CCC000001
1000000001
1111111101
1E00000001
1111111111
