11111111101111111
1PCCCCC00000000E1
11111111111111111
